true

0

20
20

3

01 02 02 02 02 02 02 02 02 02 02 02 02 02 02 02 02 02 02 03
08 00 00 00 00 00 00 00 00 00 00 00 00 00 00 00 00 00 00 04
08 00 00 00 00 00 00 00 00 00 00 00 00 00 00 00 00 00 00 04
08 00 00 00 00 00 00 00 00 00 00 00 00 00 00 00 00 00 00 04
08 00 00 00 00 00 00 00 00 00 00 00 00 00 00 00 00 00 00 04
08 00 00 00 00 00 00 00 00 00 00 00 00 00 00 00 00 00 00 04
08 00 00 00 00 00 00 00 00 00 00 00 00 00 00 00 00 00 00 04
08 00 00 00 00 00 00 00 00 00 00 00 00 00 00 00 00 00 00 04
08 00 00 00 00 30 30 00 00 00 30 00 00 00 00 00 00 30 00 04
08 -1 00 30 30 00 00 00 00 00 00 00 00 30 00 30 00 00 00 50
08 00 00 00 00 00 30 00 00 30 00 30 00 00 30 00 00 00 30 50
08 00 00 00 00 00 00 30 30 00 00 00 00 00 00 00 00 00 00 50
08 00 00 00 00 00 00 00 00 00 00 00 00 00 00 00 00 00 00 04
08 00 00 00 00 00 00 00 00 00 00 00 00 00 00 00 00 00 00 04
08 00 00 00 00 00 00 00 00 00 00 00 00 00 00 00 00 00 00 04
08 00 00 00 00 00 00 00 00 00 00 00 00 00 00 00 00 00 00 04
08 00 00 00 00 00 00 00 00 00 00 00 00 00 00 00 00 00 00 04
08 00 00 00 00 00 00 00 00 00 00 00 00 00 00 00 00 00 00 04
08 00 00 00 00 00 00 00 00 00 00 00 00 00 00 00 00 00 00 04
07 06 06 06 06 06 06 06 06 06 06 06 06 06 06 06 06 06 06 05