true

0

20
20

3

01 02 02 02 02 02 02 02 02 02 02 02 02 02 02 02 02 50 02 03
08 00 00 00 00 00 00 00 00 00 00 00 00 00 23 00 23 23 23 04
08 00 00 00 00 00 00 00 00 00 00 00 00 00 00 00 23 23 23 04
08 00 00 00 00 00 00 00 00 00 00 00 00 00 00 30 00 23 23 04
08 00 00 00 00 00 00 00 00 00 00 00 00 00 00 30 00 00 00 04
08 00 00 00 00 00 00 00 00 00 00 00 00 00 00 00 00 30 23 04
08 00 00 00 00 00 00 00 00 00 00 00 00 00 00 30 00 00 00 04
08 00 00 00 00 00 00 00 00 00 00 00 00 30 00 30 00 00 00 04
08 00 00 00 00 30 00 00 00 00 00 00 00 30 00 00 00 00 00 04
08 -1 00 30 30 00 30 00 30 00 30 30 30 00 00 00 00 00 00 04
08 00 00 00 00 00 00 00 00 30 00 00 00 00 00 00 00 00 00 04
08 00 00 00 00 00 00 00 00 00 00 00 00 00 00 00 00 00 00 04
08 00 00 00 00 00 00 00 00 00 00 00 00 00 00 00 00 00 00 04
08 00 00 00 00 00 00 00 00 00 00 00 00 00 00 00 00 00 00 04
08 00 00 00 00 00 00 00 00 00 00 00 00 00 00 00 00 00 00 04
08 00 00 00 00 00 00 00 00 00 00 00 00 00 00 00 00 00 00 04
08 00 00 00 00 00 00 00 00 00 00 00 00 00 00 00 00 00 00 04
08 00 00 00 00 00 00 00 00 00 00 00 00 00 00 00 00 00 00 04
08 00 00 00 00 00 00 00 00 00 00 00 00 00 00 00 00 00 00 04
07 06 06 06 06 06 06 06 06 06 06 06 06 06 06 06 06 06 06 05

14 1
16 1
17 1
18 1
16 2
17 2
18 2
17 3
18 3
18 5