false

0

10
10

4

01 02 02 02 02 02 02 02 02 03
08 -1 00 00 00 00 00 00 20 50
08 00 00 00 00 00 00 00 21 50
08 00 00 00 00 00 00 00 21 04
08 00 00 00 00 00 00 00 21 04
08 00 00 00 00 00 00 00 22 04
08 00 00 00 00 00 00 00 00 04
08 00 00 00 00 00 00 00 00 04
08 00 00 00 00 00 00 00 00 04
07 06 06 06 06 06 06 06 06 05

8 1
8 2
8 3
8 4
8 5